5555555555555555555555555555555555555555555555555555555555555555555555555555
----------------------------------------------------------------------555555
----555-------------B-V------------------------55555--------Z---------555555
---Z----------------555----Z-----H------------------------------------555555
-------------P-5----------------555-----------------------------------555555
-----------55555--------------------------------55555-------B---------555555
---------555------------Z-------------------------Z--------555--------555555
-----------Z--------------B------555--------Z-------------------------555555
555---------------------55555------------------------------H----------555555
---5555---------------------------Z----------------------55555--------555555
--------5-----55----------Z-------------------------------------------555555
-----------------------------------55555----H---------Z--------B------555555
---Z--------55555-------------------------555555----------------------555555
-------B--5555---------B------555--------------555--------------------555555
-------------------------------------------------------H-555----------555555
----H---C----C-H------H------C-C-HH-C---C-------C-C----H--C-----------555555
5555555555555555555555555555555555555555555555555555555555555555555555555555