%%%%%%%%%%%%%%%%%%%%%%%%%%%%%%%%%%%%%%%%%%%%%%%%%%%%%%%%%%%%%%%%%%%%%%%%%%%%%%
-----------------------------------------------------------X-------X--%%%%%%%%
-------X------------------------X--------S---------------------X--X---%%%%%%%%
-------------------------------------B--%%----------------------------%%%%%%%%
---------X----L--------------B-------%%-------------------------------%%%%%%%%
------------%%%%%----------%%%----------------------------------------%%%%%%%%
-----------------------------------------------%%-------X-------------%%%%%%%%
---X--------------------M-------------------------------L-------------%%%%%%%%
-%%%------------------%%%%------X-----%-V--------------%%%------------%%%%%%%%
----------X------------------------S---%%-----------------------------%%%%%%%%
------------------%--------B--A--%%%%%%-------------------------------%%%%%%%%
------------------------%%%%%%%%%---L-X---X---X----V---L-A-S----X-X---%%%%%%%%
-----X---------X------%%----------------------------%%%%%%%%%---------%%%%%%%%
--------M------%%-------L-------M--------B-----P------M------B------M-%%%%%%%%
---V----------B-------V-----------------------------------------------%%%%%%%%
----v--A----C----A----C----A--A----C--------AC-------V---A----C-------%%%%%%%%
%%%%%%%%%%%%%%%%%%%%%%%%%%%%%%%%%%%%%%%%%%%%%%%%%%%%%%%%%%%%%%%%%%%%%%%%%%%%%%