6666666666666666666666666666666666666666666666666666666666666666666666666666
-----------------6-6---6--6--6--66--6-6--6--6-66--66-66-6-6--6-------------6
------66-6-6--6--66-6-6-6-6-6-6-66-6-66--6-6-66-6-6-6-6-6-6-6--6-6---------6
66666666666666666666666666666---------666666666666666666--6-6-6-66--6------6
---------------------------------------------------------------------------6
------------66666----------------------------------------------------------6
---------------------------------------------------------------------X-X-X-6
---------------------------X-X-X-----------------------X-X-X--XX-X-X-------6
--------X-X-X---X--X--666--------------666---666---------------------------6
----------------------------------X-X-X6666--------------------------------6
-------Z-Z-Z--Z-----------------X666666666---------------------------------6
---------------------S-------------------------XX--X-X---------------------6
-V--V----L--B---M-6666666--S---L-M--L--B-------M--------66666666666666666666
-----V----M-SL--P-----L-B-Z-Z-Z-Z-Z-Z-Z-Z-ZZ--M--L--------L--M------B------6
-----V-B-S-------M--S------M------B----M---M--------M----------------------6
----------------Z-Z-Z-Z-Z--------C-C-C-C--C-C-Z-Z-Z-Z-Z-Z-C-C-C-C--C-C-C-C-6
6666666666666666666666666666666666666666666666666666666666666666666666666666