----------------------------------------------------------------------------
----------------------------------------------------------------------------
----------------------------------------------------------------------------
----B---B----------------Z-Z-Z----Z-Z--Z-Z--ZZZ-----------------------------
--5555555555-VV-S--------------55555555555555-------------------------------
------------55555----------------------------Z-Z--Z--MZ--Z---ZZZZ-----------
--------------------------M-S---------------55555555555555555---------------
------------------------S-555-----------B-----L-----ZZ---Z-Z-Z--------------
-------------------V--555---------------55---55----Z-Z--Z---Z---------------
------------------5--------------M------5555-----5555555555555555-----------
-------------------------------5555--------------------Z-------Z------------
----------------V-----------M--5555------Z----------Z-------Z---------------
---------------5555555555555555----Z-----Z-----Z------Z-------55555---------
-V-VV-S--L-S-5555555555---L------------Z----Z----------Z---55555------------
--V--V--M-----M----M------B----------B--------Z-B---Z-----------------------
-------------------------------ZZZ-------ZZ------Z-----------Z--------------
5555555555555555555555555555555555555555555555555555555555555555555555555555