77777777777777777777777777777777777777777777777777777777777777777777777777
-------------------------------------------------------------------------7
-------------------------------------------77------------------777-------7
------------------------------------77--77-------------------------------7
-------------B---L-------------------77----------------------------------7
-----------77777777-------7777-------------------------------------------7
------------------------------777----------------------------------------7
---X-------------------BBB-----------------------------------------------7
---------------------777777-----------@---7@@----------------------------7
---LL--VVVLVVSP--------------------------------S-B-@@--------------------7
--------------&M-V---L----P------&&&&&&&-----P------------B--------------7
-7V77@7754&&%%%&&V-VVS--L-S--V--V---V-L-M-----B---P-------%%%--P---------7
---V-L-V-V-SV-V-M-&5-SM--S-M--M-L--M-M-X-X-X-X-X-X-B-L-----S--M-X--M-----7
--V-L--S----P----M-------------------------------------------------------7
---V---------------------------------------------------------------------7
------------------G------------------------------------------G--G--------7
77777777777777777777777777777777777777777777777777777777777777777777777777