----------------------------------------
#------------#######--------------------
#---------------------------------------
----------------------------------------
----------------------------------------
---------------------------#------------
---#-------------#-------------------#--
----------------------------------------
----------------------############------
############----------------####--------
----------------------------------------
----------------------------------------
--------------------------------########
------------########--------------------
----------------------------------------
----------------------------------------
########################################