---------------------------------------------------------------------
---------------------------------------------------------------------
---------------------------------------------------------------------
-------------------------Z-Z-Z----Z-Z--Z-Z--ZZZ----------------------
--5555555555-VV-S--------------55555555555555------------------------
------------55555----------------------------Z-Z--Z---Z--Z---ZZZZ----
----------------------------S---------------55555555555555555--------
------------------------S-555-----------B-----L-----ZZ---Z-Z-Z-------
-------------------V--555--------------555---55----Z-Z--Z---Z--------
------------------555------------M-----55555-----5555555555555555----
-------------------------------55555-------------------Z-------Z-----
----------------V-----55----M---555------Z----------Z-------Z--------
---------------5555555555555555----Z-----Z-----Z------Z-------55555--
------S----S---55555555----------------Z----Z----------Z---55555-----
--V-------------------------------------------Z-----Z----------------
V-V-V--------------------------ZZZ-------ZZ------Z-----------Z-------
555555555555555555555555555555555555555555555555555555555555555555555