44444444444444444444444444444444444444444444444444444444444444444444444444
-----4-----------4---------4------------4--------------4------------------
------------4-------4------------------------------4----------------------
-----4----------------------------4---------------4-----------------------
------4---444444444--------4-------------4--------------------------------
----------4------4-------------------------4------------------------------
----------4444444----------------------------4----------------------------
---------------4-------------------------------------4--------------------
-----44-----------4---------44-----------------44------------4------------
----4--4---4----------------------4-----4444-----------4------------------
----4-------4----4---------4-----4444444----4------4------4---------------
4--4-44444444-4-444444444444444444---4--4-4--4---4-4--444444--------------
---------------4--------------4-----------------------------M-------------
--V-V-S-----L--M--S--------M----M-----S--------M-----------4444444--------
-VVV----L----M--------M-------------------M-------------M-----------------
----E-----E---E--E--E-E-E-E-E-E-E-E-EE--EEE--E--E--E--EEE-E--E------------
44444444444444444444444444444444444444444444444444444444444444444444444444