-------------------------------------------------------------------
-------------------------------------------------------------------
-------------------------------------------------------------------
-------------------------------------------------------------------
-------------------------------------------------------------------
------------44444--------------------------------------------------
-------------------------------------------------------------------
-------------------------------------------------------------------
----------------------4-------------4---4--------------------------
---------------------------------------4444------------------------
---------------------------------4444444---------------------------
-------------------------------------------------------------------
------------------44444444444-------------------------444444-------
-----------------------------------------------------------4444444-
-------------------------------------------------------------------
----L---------L--------------L-------------------------------------
4444444444444444444444444444444444444444444444444444444444444444444