---------------------------------------------------------------------
#------------#######-----------------------------------------###-----
#---------------------------------###########------------------------
---------------------------------------------------------------------
---------------------------------------------------------------------
--------------------------##-------------------------#####-----------
--##-----------------------------------------------------------------
---------------------------------------------------------------------
---------------------------------------------------------------------
############----------------------------########---------------------
---------------------------------------------------------------------
---------------------------------------------------------------------
---------------------------------------------------------------------
---------------#########------------------------###############------
---------------------------------------------------------------------
---------------------------------------------------------------------
#####################################################################