4444444444444444444444444444444444444444444444444444444444444444444444444444
-----4-----------4---------4------------4--------------4--------------444444
------------4-------4------------------------------4------------------444444
-----4----------------------------4---------------4-------------------444444
------4---444444444--------4-------------4----------------------------444444
----------4------4-------------------------4--------------------------444444
----------4444444----------------------------4------------------------444444
-------------XXX-X-X--XX-X-X-X-X-XX-X-X-X-X---XX----X-----X-X-X-X-X-X-444444
-----44-----------4---------44-----------------44------------4--------444444
----4--4---4----------------------4-----4444-----------4--------------444444
----4-------4----4---------4-----4444444----4------4------4-----------444444
4----44444444-4-444444444444444444---4--4-4--4---4-4--444444----------444444
--V-V-V-L-M----4-M----M-------4M---M-M--M-------M---S-------M---P-----444444
--V-V-S-----L--M--S--------M----M--L--S--------M-M---M-----4444444----444444
----------------------------------------------S--------S--------------444444
----E-----E---E--E-------E------E----E----E-----E----E-E--E----E------444444
4444444444444444444444444444444444444444444444444444444444444444444444444444