777777777777777777777777777777777777777777777777777777777777777777
------------------------------------------------------------------
-------------------------------------------77------------------777
------------------------------------77--77------------------------
-------------B---L-------------------77---------------------------
-----------77777777-------7777------------------------------------
------------------------------777---------------------------------
---X-------------------BBB----------------------------------------
---------------------777777-----------@---7@@---------------------
-----------------------------------S-B-@@-------------------------
------------------%--------------&&&&&&&--------------------------
-7-77@7754&&%%%&&%%-------S-------------M-----------------%%%-----
-------------------5-------------------X-X-X-X-X-X---------S----X-
------V-------L--M-----------------------B-----%------------------
--V----V---M---------------M--------------------------------------
---V----S---------G------------------------------------------G--G-
777777777777777777777777777777777777777777777777777777777777777777