&&&&&&&&&&&&&&&&&&&&&&&&&&&&&&&&&&&&&&&&&&&&&&&&&&&&&&&&&&&&&&&&&&&&&
&&&------------&&&&&-----------------------------------------&&&-----
&&&&--------------------X------------&&&&&&&-------------------------
----------------------------------------XXXX-X--X--X-X-XX--X--X--X---
---------X---X--X-----X---B--------X---X---------------X-X-xx--XXXX--
----------------------------------------X----------&&&&&-------------
-------------X-X--------X-----------------------------------------&&&
-----------------------X---------------------------------------------
-----E---------------------------------v--B----M---------------------
------------XXXX-----X--X-X---X---X--&&&&&&&&&&&&&&&-----------------
-XX-X-X--XX-X-XZ------Z-------Z-----Z------Z---------Z---&&&&&&&&&&&&
------------------------&&&&&------------&&&&&&&&&---------&&&&&&&&&&
------------------&&&&&----------------------B------M-------&&&&&&&&&
-------B----L----------Z---------------------------------------------
---V----------S------------------------------------------------------
--VV------------C-C-C-C--C-C-C-C-C----Z-Z-Z-Z-Z-Z-Z-Z-Z--------------
&&&&&&&&&&&&&&&&&&&&&&&&&&&&&&&&&&&&&&&&&&&&&&&&&&&&&&&&&&&&&&&&&&&&&