---------------------------------------------------------------------
---------------------------------------------------------------------
---------------------------------------------------------------------
---------------------------------------------------------------------
---------------------------------------------------------------------
------------55555----------------------------------------------------
---------------------------------------------------------------------
---------------------------------------------------------------------
----------------------555--------------555---55---------------------------
---------------------------------------55555---------------------------
---------------------------------55555---------------------------
---------------------------------------------------------------------
------------------5555555555555-------------------------------55555---------
-----------------------------------------------------------55555--------
---------------------------------------------------------------------
---------------------------------------------------------------------
555555555555555555555555555555555555555555555555555555555555555555555