5555555555555555555555555555555555555555555555555555555555555555555555555555
----------------------------------------------------------------------555555
----------------------------------------------------------------------555555
----B---B----------------Z-Z-Z----Z-Z--Z-Z--ZZZ-----------------------555555
--5555555555-VV-S--------------55555555555555-------------------------555555
------------55555----------------------------Z-Z--Z--MZ--Z---ZZZZ-----555555
--------------------------M-S---------------55555555555555555---------555555
--------------------------555-----------B-----L-----ZZ---Z-Z-Z--------555555
-------------------V--------------------55---55----Z-Z--Z---Z---------555555
------------------5------------L-B------5555-----5555555555555555-----555555
---V--V--V------------P---L-S--5555--------------------Z-------Z------555555
--V-L-V-V-------V----55--5555--5555------Z----------Z-------Z---------555555
-V---V-M-B-----55-----5555-5555-L--ZL-B--Z-L---Z------ZB--S---55555---555555
-----------M--M--L---------------------Z-M--Z--S-M-L---Z-B-------B----555555
-------M------S----B---S-----B-S--------------M------M----------------555555
------------------------C------ZZZ-------ZZ------Z------C----Z--------555555
5555555555555555555555555555555555555555555555555555555555555555555555555555