----------------------------------------------------------------------------
-----------------6-6---6--6--6--66--6-6--6--6-66--66-66-6-6--6--------------
------66-6-6--6--66-6-6-6-6-6-6-66-6-66--6-6-66-6-6-6-6-6-6-6--6-6----------
66666666666666666666666666666---------666666666666666666--6-6-6-66--6-------
----------------------------------------------------------------------------
------------66666-----------------------------------------------------------
---------------------------------------------------------------------X-X-X-X
---------------------------X-X-X--X-X-X-X-X-X--X-X-X-X-X-X-X--XX-X-X--------
--------X-X-X---X--X--666--------------666---666----------------------------
----------------------------------X-X-X6666---------------------------------
-------Z-Z-Z--Z-X-X-X-X-X-X-X-X-X666666666----------------------------------
----------------------------------X-X-X-X-X--X-XX--X-X--X-X--X-X-X-X--------
-VV-V---ML--------6666666--------M-----B-------M--------66666666666666666666
-V-V-V-S--M-SL---B----L-B-Z-Z-Z-Z-Z-Z-Z-Z-ZZ--M--------------M--------------
-SL--V-B-S---B---M--S------M------B----M---M--------M-----------------------
----------------Z-Z-Z-Z-ZCCC-C-C-C-C-C-CC-C-C-Z-Z-Z-Z-Z-Z-C-CCC-CC-C-C-C-C-C
6666666666666666666666666666666666666666666666666666666666666666666666666666