4444444444444444444444444444444444444444444444444444444444444444444444444444
-----------------------------------L-----44444------------------------444444
-----------X---B------------------444---------------------------X----4444444
----S--------4444---------X--X---------------------------L------------444444
-444444------------------------------V--H------X-------44444----------444444
-----Z---H-S-----------Z-----------44444444---------------------------444444
---------444444------------X------------------------------------------444444
-----Z----------------L--------------------------444444--------X------444444
-------------------P-444444------------Z--------S--------------L------444444
---------X--------444444----------------------------44444-------------444444
--B------------4444----Z----------B-H-----X------------S---4444-------444444
44444-----Z----------------X-----4444-V----------L--------------------444444
--------------B---------------------44444-------------Z-----B---------444444
----V-------4444------Z-------S--------V---------X--------44444-------444444
---V-L-------------------------B--------------L----------------V------444444
------E---C---EH-H----C-------E--V---HC-H-E-------EH---C--E----H------444444
4444444444444444444444444444444444444444444444444444444444444444444444444444