%%%%%%%%%%%%%%%%%%%%%%%%%%%%%%%%%%%%%%%%%%%%%%%%%%%%%%%%%%%%%%%%%%%%%%%%%%%%%%
-------------------------------------------------------X-X-X-X-X-X-X-X%%%%%%%%
-------------------------------------------%-------------------X--X---%%%%%%%%
----------------------------------------%-----------------------------%%%%%%%%
--------------L----------------------%--------------------------------%%%%%%%%
------------%%%%%----------%%-----------------------------------------%%%%%%%%
------------------------------%---------------------------------------%%%%%%%%
---X-------------------BBB------------P-------------------------------%%%%%%%%
----------------------%%%%------------%---%---------------------------%%%%%%%%
-------------------------------------B-%%-----------------------------%%%%%%%%
------------------%--------------%%%%%%-------------------------------%%%%%%%%
--S---M----------M-%-S---%%%%%%%%%---L-X-X-X-X-X-X--------P-----X-X---%%%%%%%%
-----X---X-----X------Z-Z-Z-Z-Z---------M-----------------%%%---------%%%%%%%%
--V---V-----S--M-M--V---L-----S-M---S----B-----L--S---M------M------M-%%%%%%%%
----V-V--L--------B--------B------------------------------------------%%%%%%%%
----------------Z-C-C-C-C-Z-Z---------------------------C-C-Z-C-Z-C---%%%%%%%%
%%%%%%%%%%%%%%%%%%%%%%%%%%%%%%%%%%%%%%%%%%%%%%%%%%%%%%%%%%%%%%%%%%%%%%%%%%%%%%