&&&&&&&&&&&&&&&&&&&&&&&&&&&&&&&&&&&&&&&&&&&&&&&&&&&&&&&&&&&&&&&&&&&&&&&&&&&&&&
&&&------------&&&&&--------------------B--------------------&&&------&&&&&&&&
&&&&--------------------X------------&&&&&&&--------------------------&&&&&&&&
------S---------------------------------------------------X-----------&&&&&&&&
---&&&&&-----------M---------------------X------------B---------------&&&&&&&&
-------------X----&&&-----------Z-------------X----&&&&&&&------------&&&&&&&&
----------------------------------B-----------------------------------&&&&&&&&
--------X----------------------&&&&&--------------B--------------------&&&&&&&&
--------S---M-----B---Z--------------------------&&&---------X--------&&&&&&&&
-------&&&&&&&&&&&&&&&----------------------------P----S--------------&&&&&&&&
---------X-------------------S----M-V-----------&&&&&&&&&-------------&&&&&&&&
-----------------------------&&&&&&&&------X--------------------------&&&&&&&&
---------Z----------M------------------------------L----------X-------&&&&&&&&
---V------------&&&&&----------Z------------------&&&-----------------&&&&&&&&
------M--------------V--------M--------------M-----V------------V-----&&&&&&&&
---------C-------Z--------C------C-------C---C------C--------C--------&&&&&&&&
&&&&&&&&&&&&&&&&&&&&&&&&&&&&&&&&&&&&&&&&&&&&&&&&&&&&&&&&&&&&&&&&&&&&&&&&&&&&&&