%%%%%%%%%%%%%%%%%%%%%%%%%%%%%%%%%%%%%%%%%%%%%%%%%%%%%%%%%%%%%%%%%%%%%%%%%%%%%%
------------------------------------------------------------------------------
-------------------------------------------%-------------------X--X-----------
----------------------------------------%-------------------------------------
-----------------L-------------------%----------------------------------------
------------%%%%%----------%%-------------------------------------------------
------------------------------%-----------------------------------------------
---X-------------------BBB----------------------------------------------------
----------------------%%%%------------%---%-----------------------------------
-------------------------------------B-%%-------------------------------------
------------------%--------------%%%%%%---------------------------------------
-------------------%-----%%%%%%%%%-----X-X-X-X-X-X--------------X-X-----------
-----X---X-----X------Z-Z-Z-Z-Z---------M-----------------%%%-----------------
--VV--V--L--S----M-----------------------B------------------------------------
-S-LM---V-M-M---------------M-------------------------------------------------
----------------Z-C-C-C-C-Z-Z---------------------------C-C-Z-C-Z-C-----------
%%%%%%%%%%%%%%%%%%%%%%%%%%%%%%%%%%%%%%%%%%%%%%%%%%%%%%%%%%%%%%%%%%%%%%%%%%%%%%