---------------------------------------------------------------------
---------------------------------------------------------------------
---------------------------------------------------------------------
---------------------------------------------------------------------
---------------------------------------------------------------------
------------#####----------------------------------------------------
---------------------------------------------------------------------
---------------------------------------------------------------------
-------------------------------------#---#---------------------------
-----------------------------------------#---------------------------
---------------------#------------########---------------------------
---------------------------------------------------------------------
------------------#######-------------------------------####---------
-----------------------------------------------------------##--------
---------------------------------------------------------------------
---------------------------------------------------------------------
#####################################################################