----------------------------------------------------------------------@--------
@------------@@@@@@-----------------------------------------@@@--------@-------
@---------------------------------@@@@@@@@@-----------------------------@------
-------------------------------------------------------------------------@----@
--------------------------B-----------------------------------------------@---@
--------------------------@@-------------------------@@@@@----------------@@-@@
--@@----------------------------------------------------------------------@@@@@
-----------------------X-------------------------------------------------------
-----X---------------------@@@@@--------------B--------------------------------
@@@@@@------@@@----------------------@@@@@-------------------------------------
@@@@@@@@-----------------------------------------------------------------------
-------------------------------------------------------------------------------
XXXXXXXXXX-X-X-X-XX--X-X-XX----X-X--X---------@@@@@@@@@@-B---------------------
----------------------------------------------@@@@@@@@@------------------P-----
-------------------------------------------------------------------------------
--ZZZZZ-Z-Z-Z-Z-Z-Z-Z-Z-Z-Z-Z-Z-Z--C-C-C-C-C-C---------------------------------
@@@@@@@@@@@@@@@@@@@@@@@@@@@@@@@@@@@@@@@@@@@@@@@@@@@@@@@@@@@@@@@@@@@@@@@@@@@@@@@