&&&&&&&&&&&&&&&&&&&&&&&&&&&&&&&&&&&&&&&&&&&&&&&&&&&&&&&&&&&&&&&&&&&&&&&&&&&&&&
&&&------------&&&&&-----------------------------------------&&&------&&&&&&&&
&&&&--------------------X------------&&&&&&&--------------------------&&&&&&&&
----------------------------------------XXXX-X--X--X-X-XX--X--X--X----&&&&&&&&
---------X---X--X-----X---B--------X---X---------------X-X-xx--XXXX---&&&&&&&&
----------------------------------------X----------&&&&&--------------&&&&&&&&
-------------X-X--------X-----------------------------------------&&&&&&&&&&&&
-----------------------X----------------------------------------------&&&&&&&&
---------------------------------------v--B----M----------------------&&&&&&&&
---------------------X--X-X---X---X--&&&&&&&&&&&&&&&------------------&&&&&&&&
---------XX-X-XZ------Z-------Z-----Z------Z---------Z---&&&&&&&&&&&&&&&&&&&&&
--VVVV-S-L-S---B-M-P----&&&&&--B---B---S-&&&&&&&&&-S--M----&&&&&&&&&&&&&&&&&&&
---S----M-M-------&&&&&----S------M-L----M-L-B------M-------&&&&&&&&&&&&&&&&&&
-VV-VV------L----M--L-MZ---B-M---------S-------M------S---------------&&&&&&&&
---------M-----B-----------L----------------------------------S--M----&&&&&&&&
----------------C-C-C-C--C-C-C-C-C----Z-Z-Z-Z-Z-Z-Z-Z-Z---------------&&&&&&&&
&&&&&&&&&&&&&&&&&&&&&&&&&&&&&&&&&&&&&&&&&&&&&&&&&&&&&&&&&&&&&&&&&&&&&&&&&&&&&&