---------------------------------------------------------------------
-----------------6-6---6--6--6--66--6-6--6--6-66--66-66-6-6--6-------
------66-6-6--6--66-6-6-6-6-6-6-66-6-66--6-6-66-6-6-6-6-6-6-6--6-6---
66666666666666666666666666666---------666666666666666666--6-6-6-66--6
---------------------------------------------------------------------
------------66666----------------------------------------------------
---------------------------------------------------------------------
---------------------------X-X-X--X-X-X-X-X-X--X-X-X-X-X-X-X--XX-X-X-
---X-X-X-X-XX---X--X--666--------------666---666---------------------
XXX-X-X-X-X--XX-------------------X-X-X6666--------------------------
-------Z-Z-Z--Z-X-X-X-X-X-X-X-X-X666666666---------------------------
----------------------------------X-X-X-X-X--X-XX--X-X--X-X--X-X-X-X-
--------ML--------6666666-------------------------------6666666666666
----------M-----------L---Z-Z-Z-Z-Z-Z-Z-Z-ZZ-------------------------
---E-V-------B---M--SZ-Z-ZZ--ZZ-------------ZZ--Z-Z-Z-Z-ZZ-ZZ-Z------
-V-V------V-----Z-Z-Z-Z-ZCCC-C-C-C-C-C-CC-C-C-Z-Z-Z-Z-Z-Z-----C-CC---
666666666666666666666666666666666666666666666666666666666666666666666