%%%%%%%%%%%%%%%%%%%%%%%%%%%%%%%%%%%%%%%%%%%%%%%%%%%%%%%%%%%%%%%%%%%%%%%%%%%%%%
-----------------------------------------------------------X-------X--%%%%%%%%
-------X------------------------X--------S---------------------X--X---%%%%%%%%
-------------------------------------B--%%----------------------------%%%%%%%%
---------X----L--------------B-------%%-------------------------------%%%%%%%%
------------%%%%%----------%%%----------------------------------------%%%%%%%%
-----------------------------------------------%%-------X-------------%%%%%%%%
---X--------------------M-------------------------------L-------------%%%%%%%%
-%%%------------------%%%%------X-----%-V--------------%%%------------%%%%%%%%
----------X------------------------S---%%-----------------------------%%%%%%%%
------------------%--------B-----%%%%%%-------------------------------%%%%%%%%
------------------------%%%%%%%%%---L-X---X---X----V---L---S----X-X---%%%%%%%%
-----X---------X------%%----------------------------%%%%%%%%%---------%%%%%%%%
--------M------%%-------L-------M--------B-----P------M------B------M-%%%%%%%%
--------------B-------V-----------------------------------------------%%%%%%%%
-------C---------C-----------------C---------C-------V--------C-------%%%%%%%%
%%%%%%%%%%%%%%%%%%%%%%%%%%%%%%%%%%%%%%%%%%%%%%%%%%%%%%%%%%%%%%%%%%%%%%%%%%%%%%