---------------------------------------------------------------------
&&&------------&&&&&-----------------------------------------&&&-----
&&&&---------------------------------&&&&&&&-------------------------
---------------------------------------------------------------------
--------------------------B------------------------------------------
--------------------------##-------------------------&&&&&-----------
--&&&----------------------------------------------------------------
-----------------------X---------------------------------------------
-----E------------------------------------B--------------------------
&&&&&&&&&-----------------X----------&&&&&&&&&&&&&&&-----------------
---------------------------------------------------------------------
---------------------------------------------------------------------
-----------&&&&&&&&&----------------------------------B--------------
-------B-------------------------------&&&&&&&&&&&&&&&&&-------------
------------G--------------------------------------------------------
------Z-------E-M-S-L-V-P----------------------Z---------------------
&&&&&&&&&&&&&&&&&&&&&&&&&&&&&&&&&&&&&&&&&&&&&&&&&&&&&&&&&&&&&&&&&&&&&