5555555555555555555555555555555555555555555555555555555555555555555555555555
---------------------------------------------------------------------------5
---------------------------------------------------------------------------5
----B---B----------------Z-Z-Z----Z-Z--Z-Z--ZZZ----------------------------5
--5555555555-VV-S--------------55555555555555------------------------------5
------------55555----------------------------Z-Z--Z--MZ--Z---ZZZZ----------5
--------------------------M-S---------------55555555555555555--------------5
------------------------S-555-----------B-----L-----ZZ---Z-Z-Z-------------5
-------------------V--555---------------55---55----Z-Z--Z---Z--------------5
------------------5------------L-B------5555-----5555555555555555----------5
---V--V--V----------------L----5555--------------------Z-------Z-----------5
--V-L-V-VS-M--LSV--B-P--S---M--5555------Z----------Z-------Z--------------5
-V---V-M-B-MB-M5555555555555555-L--ZL-B-SZ-L-S-Z-SB-S-ZB--S---55555--------5
-------------5555555555----------------Z-M--Z--S-M-L--SZ-B-55555-B---------5
---------------------------------------------------------------------------5
-------------------------------ZZZ-------ZZ------Z-----------Z-------------5
5555555555555555555555555555555555555555555555555555555555555555555555555555