6666666666666666666666666666666666666666666666666666666666666666666666666666
-----------------6-6---6--6--6--66--6-6--6--6-66--66-66-6-6--6--------666666
------66-6-6--6--66-6-6-6-6-6-6-66-6-66--6-6-66-6-6-6-6-6-6-6--6-6----666666
66666666666666666666666666666---------666666666666666666--6-6-6-66--6-666666
----------------------------------------------------------------------666666
------------66666-----------------------------------------------------666666
---------------------------------------------------------------------X666666
---------------------------X-X-X-----------------------X-X-X--XX-X-X--666666
--------X-X-X---X--X--666--------------666---666----------------------666666
----------------------------------X-X-X6666---------------------------666666
-------Z-Z-Z--Z-----------------X666666666----------------------------666666
---------------------S-------------------------XX--X-X----------------666666
-V--V----L--B---M-6666666--S---L-M--L--B-------M--------66666666666666666666
-----V----M-SL--P-----L-B-Z-Z-Z-Z-Z-Z-Z-Z-ZZ--M--L--------L--M------B-666666
-----V-B-S-------M--S------M------B----M---M--------M-----------------666666
----------------Z-Z-Z-Z-Z--------C-C-C-C--C-C-Z-Z-Z-Z-Z-Z-C-C-C-C--C-C666666
6666666666666666666666666666666666666666666666666666666666666666666666666666
