---------------------------------------------------------------------
---------------------------------------------------------------------
---------------------------------------------------------------------
---------------------------------------------------------------------
---------------------------------------------------------------------
------------%%%%%----------------------------------------------------
---------------------------------------------------------------------
---------------------------------------------------------------------
----------------------%--------------%---%---------------------------
---------------------------------------%%----------------------------
---------------------------------%%%%%%------------------------------
---------------------------------------------------------------------
------------------%%%%%%-------------------------------%%%-----------
-----------------------------------------------------------%%%%------
---------------------------------------------------------------------
-----------------E----E----------------------------------------------
%%%%%%%%%%%%%%%%%%%%%%%%%%%%%%%%%%%%%%%%%%%%%%%%%%%%%%%%%%%%%%%%%%%%%