&&&&&&&&&&&&&&&&&&&&&&&&&&&&&&&&&&&&&&&&&&&&&&&&&&&&&&&&&&&&&&&&&&&&&&&&&&&&&&
&&&------------&&&&&-----------------------------------------&&&-------------&
&&&&--------------------X------------&&&&&&&---------------------------------&
----------------------------------------XXXX-X--X--X-X-XX--X--X--X-----------&
---------X---X--X-----X---B--------X---X---------------X-X-xx--XXXX----------&
----------------------------------------X----------&&&&&---------------------&
-------------X-X--------X-----------------------------------------&&&&&&&&&&&&
-----------------------X-----------------------------------------------------&
---------------------------------------v--B----M-----------------------------&
---------------------X--X-X---X---X--&&&&&&&&&&&&&&&-------------------------&
---------XX-X-XZ------Z-------Z-----Z------Z---------Z---&&&&&&&&&&&&&&&&&&&&&
--VVVV-S-L-S---B-M-P----&&&&&--B---B-L-S-&&&&&&&&&-S--M----&&&&&&&&&&&&&&&&&&&
---L---S----S-----&&&&&----S------M-L----M-L-B------M-------&&&&&&&&&&&&&&&&&&
-VV-VV-B----L----M--L-MZ---B-M---------S-------M------S------S---M-----------&
-----------------------------------------------------------------------------&
----------------C-C-C-C--C-C-C-C-C----Z-Z-Z-Z-Z-Z-Z-Z-Z----------------------&
&&&&&&&&&&&&&&&&&&&&&&&&&&&&&&&&&&&&&&&&&&&&&&&&&&&&&&&&&&&&&&&&&&&&&&&&&&&&&&