&&&&&&&&&&&&&&&&&&&&&&&&&&&&&&&&&&&&&&&&&&&&&&&&&&&&&&&&&&&&&&&&&&&&&&&&&&&&&&
&&&------------&&&&&-----------------------------------------&&&--------------
&&&&--------------------X------------&&&&&&&----------------------------------
----------------------------------------XXXX-X--X--X-X-XX--X--X--X------------
---------X---X--X-----X---B--------X---X---------------X-X-xx--XXXX-----------
----------------------------------------X----------&&&&&----------------------
-------------X-X--------X-----------------------------------------&&&&&&&&&&&&
-----------------------X------------------------------------------------------
-----E---------------------------------v--B----M------------------------------
---------------------X--X-X---X---X--&&&&&&&&&&&&&&&--------------------------
---------XX-X-XZ------Z-------Z-----Z------Z---------Z---&&&&&&&&&&&&&&&&&&&&&
------------------------&&&&&------------&&&&&&&&&---------&&&&&&&&&&&&&&&&&&&
---L--------------&&&&&----------------------B------M-------&&&&&&&&&&&&&&&&&&
-VV-VV-B----L----M----MZ-----M---------S--------------------------------------
-V-VS-LS------S------B-------------B--------B-----L---------------------------
----------------C-C-C-C--C-C-C-C-C----Z-Z-Z-Z-Z-Z-Z-Z-Z-----------------------
&&&&&&&&&&&&&&&&&&&&&&&&&&&&&&&&&&&&&&&&&&&&&&&&&&&&&&&&&&&&&&&&&&&&&&&&&&&&&&