&&&&&&&&&&&&&&&&&&&&&&&&&&&&&&&&&&&&&&&&&&&&&&&&&&&&&&&&&&&&&&&&&&&&&&&&&&&&&&
&&&------------&&&&&--------------------B--------------------&&&------&&&&&&&&
&&&&--------------------X------------&&&&&&&--------------------------&&&&&&&&
----D-S---------------------------------------------------X-----------&&&&&&&&
---&&&&&-----------M---------------------X------------B---------------&&&&&&&&
-------------X----&&&-----------Z-------------X----&&&&&&&------------&&&&&&&&
----------------------------------B-----------------------------------&&&&&&&&
--------X----------------------&&&&&--------------B-------------------&&&&&&&&
--------S---M-----B---Z--------------------------&&&---------X--------&&&&&&&&
-------&&&&&&&&&&&&&&&----------------------------P----S--------------&&&&&&&&
---------X-------------------S----M-V-----------&&&&&&&&&-------------&&&&&&&&
-----------------------------&&&&&&&&------X--------------------------&&&&&&&&
---------Z----------M---------------------------F--L----------X-------&&&&&&&&
---V------------&&&&&----------Z-------------&&&&&--------------------&&&&&&&&
------M--------------V---&----M--------------M-----V------------V-----&&&&&&&&
------D--C---N-F-Z--------C--F---C-------C---CN-----C--D-----C--------&&&&&&&&
&&&&&&&&&&&&&&&&&&&&&&&&&&&&&&&&&&&&&&&&&&&&&&&&&&&&&&&&&&&&&&&&&&&&&&&&&&&&&&