%%%%%%%%%%%%%%%%%%%%%%%%%%%%%%%%%%%%%%%%%%%%%%%%%%%%%%%%%%%%%%%%%%%%
--------------------------------------------------------------------
-------------------------------------------%-------------------X--X-
----------------------------------------%---------------------------
-----------------L-------------------%------------------------------
------------%%%%%----------%%---------------------------------------
------------------------------%-------------------------------------
---X-------------------BBB------------------------------------------
----------------------%%%%------------%---%-------------------------
-------------------------------------B-%%---------------------------
------------------%--------------%%%%%%-----------------------------
-------------------%-----%%%%%%%%%-----X-X-X-X-X-X--------------X-X-
-----X---X-----X------Z-Z-Z-Z-Z---------M-----------------%%%-------
------V-----S----M-----------------------B--------------------------
--------V---M---------------M---------------------------------------
--VV------------Z-C-C-C-C-Z-Z---------------------------C-C-Z-C-Z-C-
%%%%%%%%%%%%%%%%%%%%%%%%%%%%%%%%%%%%%%%%%%%%%%%%%%%%%%%%%%%%%%%%%%%%