---------------------------------------------------------------------
#------------#######-----------------------------------------###-----
#---------------------------#################------------------------
---------------------------------------------------------------------
---------------------------------------------------------------------
--------------------------##------------#############----------------
--##------------##---------------------------------------------------
---------------------------------------------------------------------
----------------------############-----------------------------------
############----------------------------########---------------------
---------------------------------------------------------------------
---------------------------------------------------------------------
--------------------------------########-----------------------------
------------########----------------------------###############------
---------------------------------------------------------------------
---------------------------------------------------------------------
#####################################################################