--------------------------------------------------------------------------
@------------@@@@@@-----------------------------------------@@@-----------
@---------------------------------@@@@@@@@@-------------------------------
--------------------------------------------------------------------------
--------------------------B-----------------------------------------------
--------------------------@@-------------------------@@@@@----------------
--@@----------------------------------------------------------------------
-----------------------X--------------------------------------------------
-----x---------------------@@@@@--------------B---------------------------
@@@@@@------@@@----------------------@@@@@--------------------------------
@@@@@@@@------------------------------------------------------------------
--------------------------------------------------------------------------
-----X-X-X-X-X-X-XX--X-X-XX----X-X--X---------@@@@@@@@@@-B----------------
----------------------------------------------@@@@@@@@@-------------------
--------------------------------------------------------------------------
----Z-Z-Z-Z-Z-Z-Z-Z-Z-Z-Z-Z-Z-Z-Z--C-C-C-C-C-C----------------------------
@@@@@@@@@@@@@@@@@@@@@@@@@@@@@@@@@@@@@@@@@@@@@@@@@@@@@@@@@@@@@@@@@@@@@@@@@@