6666666666666666666666666666666666666666666666666666666666666666666666666666
------------------------X---------------------X-----------------------666666
----------------------------------------------------------------------666666
-------------------------------P------J---------------X----X----X-----666666
------------------X-------------V-----XX--------M---------------------666666
----------Z-----------------66666--------------666------6666----------666666
---------JL-------Z------6---------6-L---------X----------------------666666
---------666----------6-----X--------6---------------66---------------666666
------------------66------------------6--V-----66--------X--------X---666666
------------S---------------------X------6----------------------------666666
-----------666---------Z-------------------6--------------------------666666
------------------B-------------------------------Z--M----------------666666
----------------666---------Z----Z----------------6666----------------666666
-------------666--------B--------------S------6--------B--------------666666
----------------------------------------------------------------------666666
--------S-----J---CM---J----C-N-V-M---C---B-N--C----V-C--------NC-----666666
6666666666666666666666666666666666666666666666666666666666666666666666666666