4444444444444444444444444444444444444444444444444444444444444444444
-----4-----------4---------4------------4--------------4-----------
------------4-------4------------------------------4---------------
-----4----------------------------4---------------4----------------
------4---444444444--------4-------------4-------------------------
----------4------4-------------------------4-----------------------
----------4444444----------------------------4---------------------
---------------4-------------------------------------4-------------
-----44-----------4---------44-----------------44------------4-----
----4--4---4----------------------4-----4444-----------4-----------
----4-------4----4---------4-----4444444----4------4------4--------
4--4-44444444-4-444444444444444444---4--4-4--4---4-4--444444-------
---------------4--------------4------------------------------------
--V---S----------------------------------------------------4444444-
-V-----------------------------------------------------------------
-V--E-----E---E--E--E-E-E-E-E-E-E-E-EE--EEE--E--E--E--EEE-E--E-----
4444444444444444444444444444444444444444444444444444444444444444444