----------------------------------------------------------------------
@------------@@@@@@-----------------------------------------@@@-------
@---------------------------------@@@@@@@@@---------------------------
----------------------------------------------------------------------
--------------------------B-------------------------------------------
--------------------------@@-------------------------@@@@@------------
--@@------------------------------------------------------------------
-----------------------X----------------------------------------------
-----E------------------------------------B---------------------------
@@@@@@-----------------X----------@@@@@-------------------------------
@@@@@@@@--------------------------------------------------------------
----------------------------------------------------------------------
-----------------------------------------------------------B----------
B---------------------------------------@@@@@@@@@---------------------
------------G---------------------------------------------------------
------Z---MM---E-M-S-L-V-P---C------------------Z----------------E---C-
@@@@@@@@@@@@@@@@@@@@@@@@@@@@@@@@@@@@@@@@@@@@@@@@@@@@@@@@@@@@@@@@@@@@@@