7777777777777777777777777777777777777777777777777777777777777777777777777777
----------------------------------------------------------------------777777
-------------------------------------------77------------------777----777777
------------------------------------77--77----------------------------777777
-------------B---L-------------------77-------------------------------777777
-----------77777777-------7777----------------------------------------777777
------------------------------777-------------------------------------777777
---X-------------------BBB--------------------------------------------777777
---------------------777777-----------@---7@@-------------------------777777
---LL--------SP--------------------------------S-B-@@-----------------777777
--------------&M-V---L----S------&&&&&&&-----P------------B-S---------777777
-7V77@7754&&%%%&&V-VV---L-----------V-L-M-----B-----------%%%--P------777777
---V-L-V-V-S--V-M-&5-SM-------M-L--M-M-X-X-X-X-X-X-B-L--------M-X--M--777777
--V-L--S----P----M----------------------------------------------------777777
---V----------B----------B------------M-------------------------------777777
------------------G------------------------------------------G--G-----777777
7777777777777777777777777777777777777777777777777777777777777777777777777777