7777777777777777777777777777777777777777777777777777777777777777777777777777
----------------------X---------------X-------------------------------777777
-------------S---------------------------------------X------V---------777777
----------4--4--4----------Z---------------Z---------------P4---------777777
------------------------B777--------V------G----------S-----65--------777777
-----X----------X---------------7-7-7-----------------&&--------------777777
----------------L-7-----V---M-7-----------------B---------------------777777
------V--------777----777777777-------5--------6%%------M--------X----777777
---5555--------------7------------V-----------------------------------777777
---------X------S---7----------------B-----4-------X------V--B--------777777
---------------&4567------------X--------Z---------------%&7654-------777777
----------------------------------------------------------------------777777
----X-------M----------------Z-----M--------Z----B--------------------777777
---------7654------------G------------------------------------G-------777777
-----------S-----V-----------------5---------------M------------------777777
------M-------C-----C-----B--C----666-------V--C-L----------C---------777777
7777777777777777777777777777777777777777777777777777777777777777777777777777