%%%%%%%%%%%%%%%%%%%%%%%%%%%%%%%%%%%%%%%%%%%%%%%%%%%%%%%%%%%%%%%%%%%%%%%%%%%%%%
-------------------------------------------------------X-X-X-X-X-X-X-X-XX-X%%%
-------------------------------------------%-------------------X--X--------%%%
----------------------------------------%----------------------------------%%%
--------------L----------------------%-------------------------------------%%%
------------%%%%%----------%%----------------------------------------------%%%
------------------------------%--------------------------------------------%%%
---X-------------------BBB------------P------------------------------------%%%
----------------------%%%%------------%---%--------------------------------%%%
-------------------------------------B-%%----------------------------------%%%
------------------%--------------%%%%%%------------------------------------%%%
--S-L-M-S-M-M-M--M-%-S---%%%%%%%%%--BL-X-X-X-X-X-X--------P-----X-X--------%%%
-----X---X-----X------Z-Z-Z-Z-Z---------M-----------------%%%--------------%%%
--VV--V--L--S--M-M--V---L-----S-----SL---B-----L--S---M------M------M------%%%
---------------------------------------------------------------------------%%%
----------------Z-C-C-C-C-Z-Z---------------------------C-C-Z-C-Z-C--------%%%
%%%%%%%%%%%%%%%%%%%%%%%%%%%%%%%%%%%%%%%%%%%%%%%%%%%%%%%%%%%%%%%%%%%%%%%%%%%%%%