&&&&&&&&&&&&&&&&&&&&&&&&&&&&&&&&&&&&&&&&&&&&&&&&&&&&&&&&&&&&&&&&&&&&&&&&&&&&&&
&&&------------&&&&&--------------------B--------------------&&&------&&&&&&&&
&&&&--------------------X------------&&&&&&&--------------------------&&&&&&&&
----D-S---------------------------------------------------X-----------&&&&&&&&
---&&&&&-----------M---------------------X------------B---------------&&&&&&&&
-------------X----&&&-----------Z-------------X----&&&&&&&------------&&&&&&&&
----------------------------------B-----------------------------------&&&&&&&&
--------X----------------------&&&&&--------------B-------------------&&&&&&&&
--------S---M-----B---Z--------------------------&&&---------X--------&&&&&&&&
-------&&&&&&&&&&&&&&&---------------------------------S--------------&&&&&&&&
---------X-------------------S----M-V-----------&&&&&&&&&-------------&&&&&&&&
-----------------------------&&&&&&&&------X--------------------------&&&&&&&&
---------Z----------M---------------------------F--L--P-------X-------&&&&&&&&
----------------&&&&&----------Z-------------&&&&&--------------------&&&&&&&&
---V--M--------------V---&----M--------------M-----V------------V-----&&&&&&&&
-V----D--C---N-F-Z--------C--F---C-------C---CN-----C--D-----C--------&&&&&&&&
&&&&&&&&&&&&&&&&&&&&&&&&&&&&&&&&&&&&&&&&&&&&&&&&&&&&&&&&&&&&&&&&&&&&&&&&&&&&&&