77777777777777777777777777777777777777777777777777777777777777777777777777
--------------------------------------------------------------------------
-------------------------------------------77------------------777--------
------------------------------------77--77--------------------------------
-------------B---L-------------------77-----------------------------------
-----------77777777-------7777--------------------------------------------
------------------------------777-----------------------------------------
---X-------------------BBB------------------------------------------------
---------------------777777-----------@---7@@-----------------------------
-----------------------------------S-B-@@---------------------------------
------------------%--------------&&&&&&&------------------B---------------
-7-77@7754&&%%%&&%%-------S-------------M-----B-----------%%%-------------
--------VV---------5--M----M-------M---X-X-X-X-X-X---------S----X---------
-V--V---------L--M-----------------------B-----%-----------M--------------
---L-V--S--M---------------M--------M----------M------M-------------------
------------------G------------------------------------------G--G---------
77777777777777777777777777777777777777777777777777777777777777777777777777