44444444444444444444444444444444444444444444444444444444444444444444444444
-----4-----------4---------4------------4--------------4-----------------4
------------4-------4------------------------------4---------------------4
-----4----------------------------4---------------4----------------------4
------4---444444444--------4-------------4-------------------------------4
----------4------4-------------------------4-----------------------------4
----------4444444----------------------------4---------------------------4
-------------XXX-X-X--XX-X-X-X-X-XX-X-X-X-X---XX----X-----X-X-X-X-X-X-X--4
-----44-----------4---------44-----------------44------------4-----------4
----4--4---4----------------------4-----4444-----------4-----------------4
----4-------4----4---------4-----4444444----4------4------4--------------4
4----44444444-4-444444444444444444---4--4-4--4---4-4--444444-------------4
--V-V-V-L-M----4-M----M-------4M---M-M--M----S--M---S---S---M---P--------4
--V-V-S-----L--M--S--------M----M--L--S--------M-M---M-----4444444-------4
-------------------------------------------------------------------------4
----E-----E---E--E-------------------------------------------------------4
44444444444444444444444444444444444444444444444444444444444444444444444444